"filename", "language", "TypeScript", "Vue", "SCSS", "Markdown", "comment", "blank", "total"
"/Users/peaker/dev/kitchen-app/backoffice/src/About/BACKOFFICE/7_Packages.md", "Markdown", 0, 0, 0, 259, 0, 79, 338
"/Users/peaker/dev/kitchen-app/backoffice/src/About/BACKOFFICE/8_Batches_ref.md", "Markdown", 0, 0, 0, 400, 0, 189, 589
"/Users/peaker/dev/kitchen-app/backoffice/src/About/BACKOFFICE/9_1_Warehouse.md", "Markdown", 0, 0, 0, 1041, 0, 278, 1319
"/Users/peaker/dev/kitchen-app/backoffice/src/About/BACKOFFICE/9_Department_Warehouse.md", "Markdown", 0, 0, 0, 1225, 0, 387, 1612
"/Users/peaker/dev/kitchen-app/backoffice/src/About/Base/ArchitecturApp.md", "Markdown", 0, 0, 0, 26, 0, 34, 60
"/Users/peaker/dev/kitchen-app/backoffice/src/About/POS/0.main.md", "Markdown", 0, 0, 0, 272, 0, 110, 382
"/Users/peaker/dev/kitchen-app/backoffice/src/About/POS/1.md", "Markdown", 0, 0, 0, 160, 0, 61, 221
"/Users/peaker/dev/kitchen-app/backoffice/src/About/POS/2_перенос.md", "Markdown", 0, 0, 0, 159, 0, 9, 168
"/Users/peaker/dev/kitchen-app/backoffice/src/About/POS/3_Shift.md", "Markdown", 0, 0, 0, 292, 0, 76, 368
"/Users/peaker/dev/kitchen-app/backoffice/src/About/POS/4_WorkFlow.md", "Markdown", 0, 0, 0, 42, 0, 21, 63
"/Users/peaker/dev/kitchen-app/backoffice/src/About/POS/5_OrderSection.md", "Markdown", 0, 0, 0, 511, 0, 156, 667
"/Users/peaker/dev/kitchen-app/backoffice/src/About/POS/6_Repository.md", "Markdown", 0, 0, 0, 36, 0, 18, 54
"/Users/peaker/dev/kitchen-app/backoffice/src/About/SCSS_MainGuide.md", "Markdown", 0, 0, 0, 250, 0, 60, 310
"/Users/peaker/dev/kitchen-app/backoffice/src/App.vue", "Vue", 0, 109, 0, 0, 3, 22, 134
"/Users/peaker/dev/kitchen-app/backoffice/src/components/atoms/buttons/ActionButton.vue", "Vue", 0, 58, 0, 0, 7, 9, 74
"/Users/peaker/dev/kitchen-app/backoffice/src/components/atoms/buttons/BaseButton.vue", "Vue", 0, 128, 0, 0, 45, 21, 194
"/Users/peaker/dev/kitchen-app/backoffice/src/components/atoms/buttons/LogoutButton.vue", "Vue", 0, 121, 0, 0, 3, 25, 149
"/Users/peaker/dev/kitchen-app/backoffice/src/components/atoms/buttons/MenuButton.vue", "Vue", 0, 41, 0, 0, 7, 7, 55
"/Users/peaker/dev/kitchen-app/backoffice/src/components/atoms/dropdowns/BaseDropdown.vue", "Vue", 0, 41, 0, 0, 7, 7, 55
"/Users/peaker/dev/kitchen-app/backoffice/src/components/atoms/feedback/AppNotification.vue", "Vue", 0, 200, 0, 0, 1, 42, 243
"/Users/peaker/dev/kitchen-app/backoffice/src/components/atoms/indicators/NotificationBadge.vue", "Vue", 0, 110, 0, 0, 7, 19, 136
"/Users/peaker/dev/kitchen-app/backoffice/src/components/atoms/indicators/StatusChip.vue", "Vue", 0, 82, 0, 0, 7, 20, 109
"/Users/peaker/dev/kitchen-app/backoffice/src/components/atoms/inputs/PinInput.vue", "Vue", 0, 197, 0, 0, 1, 46, 244
"/Users/peaker/dev/kitchen-app/backoffice/src/components/auth/PinInput.vue", "Vue", 0, -91, 0, 0, 0, -16, -107
"/Users/peaker/dev/kitchen-app/backoffice/src/components/molecules/navigation/ActionMenu.vue", "Vue", 0, 134, 0, 0, 7, 24, 165
"/Users/peaker/dev/kitchen-app/backoffice/src/components/molecules/navigation/StatusBar.vue", "Vue", 0, 72, 0, 0, 10, 15, 97
"/Users/peaker/dev/kitchen-app/backoffice/src/composables/usePersistence.ts", "TypeScript", 205, 0, 0, 0, 50, 45, 300
"/Users/peaker/dev/kitchen-app/backoffice/src/composables/usePlatform.ts", "TypeScript", 108, 0, 0, 0, 42, 35, 185
"/Users/peaker/dev/kitchen-app/backoffice/src/config/environment.ts", "TypeScript", 148, 0, 0, 0, 62, 37, 247
"/Users/peaker/dev/kitchen-app/backoffice/src/core/appInitializer.ts", "TypeScript", 50, 0, 0, 0, -23, 10, 37
"/Users/peaker/dev/kitchen-app/backoffice/src/core/appInitializerTests.ts", "TypeScript", -26, 0, 0, 0, -4, -7, -37
"/Users/peaker/dev/kitchen-app/backoffice/src/core/users.ts", "TypeScript", 59, 0, 0, 0, 33, 15, 107
"/Users/peaker/dev/kitchen-app/backoffice/src/layouts/PosLayout.vue", "Vue", 0, 107, 0, 0, 5, 18, 130
"/Users/peaker/dev/kitchen-app/backoffice/src/layouts/pos/index.ts", "TypeScript", 9, 0, 0, 0, 4, 4, 17
"/Users/peaker/dev/kitchen-app/backoffice/src/layouts/pos/posConstants.ts", "TypeScript", 80, 0, 0, 0, 4, 9, 93
"/Users/peaker/dev/kitchen-app/backoffice/src/layouts/pos/posTypes.ts", "TypeScript", 57, 0, 0, 0, 1, 6, 64
"/Users/peaker/dev/kitchen-app/backoffice/src/layouts/pos/usePosLayout.ts", "TypeScript", 84, 0, 0, 0, 17, 21, 122
"/Users/peaker/dev/kitchen-app/backoffice/src/main.ts", "TypeScript", -9, 0, 0, 0, -2, -4, -15
"/Users/peaker/dev/kitchen-app/backoffice/src/plugins/vuetify.ts", "TypeScript", 46, 0, 0, 0, -3, 0, 43
"/Users/peaker/dev/kitchen-app/backoffice/src/repositories/base/IRepository.ts", "TypeScript", 81, 0, 0, 0, 113, 42, 236
"/Users/peaker/dev/kitchen-app/backoffice/src/repositories/base/LocalStorageRepository.ts", "TypeScript", 272, 0, 0, 0, 19, 57, 348
"/Users/peaker/dev/kitchen-app/backoffice/src/repositories/base/ServiceResponse.ts", "TypeScript", 134, 0, 0, 0, 69, 32, 235
"/Users/peaker/dev/kitchen-app/backoffice/src/repositories/base/index.ts", "TypeScript", 90, 0, 0, 0, 25, 20, 135
"/Users/peaker/dev/kitchen-app/backoffice/src/router/guards/auth.guard.ts", "TypeScript", 83, 0, 0, 0, 13, 6, 102
"/Users/peaker/dev/kitchen-app/backoffice/src/router/index.ts", "TypeScript", 62, 0, 0, 0, 17, 15, 94
"/Users/peaker/dev/kitchen-app/backoffice/src/stores/account/accountBasedMock.ts", "TypeScript", 6, 0, 0, 0, 1, 3, 10
"/Users/peaker/dev/kitchen-app/backoffice/src/stores/auth.store.ts", "TypeScript", -104, 0, 0, 0, -4, -16, -124
"/Users/peaker/dev/kitchen-app/backoffice/src/stores/auth/authStore.ts", "TypeScript", 169, 0, 0, 0, 28, 36, 233
"/Users/peaker/dev/kitchen-app/backoffice/src/stores/auth/composables/index.ts", "TypeScript", 2, 0, 0, 0, 4, 2, 8
"/Users/peaker/dev/kitchen-app/backoffice/src/stores/auth/composables/useAuth.ts", "TypeScript", 59, 0, 0, 0, 21, 15, 95
"/Users/peaker/dev/kitchen-app/backoffice/src/stores/auth/composables/usePermissions.ts", "TypeScript", 39, 0, 0, 0, 19, 15, 73
"/Users/peaker/dev/kitchen-app/backoffice/src/stores/auth/index.ts", "TypeScript", 3, 0, 0, 0, 0, 1, 4
"/Users/peaker/dev/kitchen-app/backoffice/src/stores/auth/services/index.ts", "TypeScript", 1, 0, 0, 0, 4, 2, 7
"/Users/peaker/dev/kitchen-app/backoffice/src/stores/auth/services/session.service.ts", "TypeScript", 181, 0, 0, 0, 43, 36, 260
"/Users/peaker/dev/kitchen-app/backoffice/src/stores/auth/types.ts", "TypeScript", 211, 0, 0, 0, 48, 54, 313
"/Users/peaker/dev/kitchen-app/backoffice/src/stores/debug/composables/useDebugFormatting.ts", "TypeScript", -13, 0, 0, 0, -3, -5, -21
"/Users/peaker/dev/kitchen-app/backoffice/src/stores/debug/composables/useDebugStores.ts", "TypeScript", -13, 0, 0, 0, -4, -5, -22
"/Users/peaker/dev/kitchen-app/backoffice/src/stores/debug/debugService.ts", "TypeScript", -39, 0, 0, 0, -2, -6, -47
"/Users/peaker/dev/kitchen-app/backoffice/src/stores/index.ts", "TypeScript", -1, 0, 0, 0, 0, -1, -2
"/Users/peaker/dev/kitchen-app/backoffice/src/stores/menu/types.ts", "TypeScript", 17, 0, 0, 0, 1, 4, 22
"/Users/peaker/dev/kitchen-app/backoffice/src/stores/pos/core/posSystem.ts", "TypeScript", 78, 0, 0, 0, 37, 21, 136
"/Users/peaker/dev/kitchen-app/backoffice/src/stores/pos/index.ts", "TypeScript", 255, 0, 0, 0, 54, 56, 365
"/Users/peaker/dev/kitchen-app/backoffice/src/stores/pos/mocks/posMockData.ts", "TypeScript", 258, 0, 0, 0, 25, 13, 296
"/Users/peaker/dev/kitchen-app/backoffice/src/stores/pos/orders/composables.ts", "TypeScript", 264, 0, 0, 0, 92, 47, 403
"/Users/peaker/dev/kitchen-app/backoffice/src/stores/pos/orders/composables/useOrderCalculations.ts", "TypeScript", 216, 0, 0, 0, 106, 53, 375
"/Users/peaker/dev/kitchen-app/backoffice/src/stores/pos/orders/composables/useOrders.ts", "TypeScript", 172, 0, 0, 0, 69, 39, 280
"/Users/peaker/dev/kitchen-app/backoffice/src/stores/pos/orders/ordersStore.ts", "TypeScript", 641, 0, 0, 0, 125, 120, 886
"/Users/peaker/dev/kitchen-app/backoffice/src/stores/pos/orders/services.ts", "TypeScript", 552, 0, 0, 0, 39, 91, 682
"/Users/peaker/dev/kitchen-app/backoffice/src/stores/pos/payments/composables.ts", "TypeScript", 144, 0, 0, 0, 46, 22, 212
"/Users/peaker/dev/kitchen-app/backoffice/src/stores/pos/payments/paymentsStore.ts", "TypeScript", 327, 0, 0, 0, 82, 71, 480
"/Users/peaker/dev/kitchen-app/backoffice/src/stores/pos/payments/services.ts", "TypeScript", 132, 0, 0, 0, 8, 25, 165
"/Users/peaker/dev/kitchen-app/backoffice/src/stores/pos/service/DepartmentNotificationService.ts", "TypeScript", 267, 0, 0, 0, 60, 58, 385
"/Users/peaker/dev/kitchen-app/backoffice/src/stores/pos/shifts/composables.ts", "TypeScript", 273, 0, 0, 0, 91, 58, 422
"/Users/peaker/dev/kitchen-app/backoffice/src/stores/pos/shifts/index.ts", "TypeScript", 5, 0, 0, 0, 239, 18, 262
"/Users/peaker/dev/kitchen-app/backoffice/src/stores/pos/shifts/mock.ts", "TypeScript", 356, 0, 0, 0, 51, 54, 461
"/Users/peaker/dev/kitchen-app/backoffice/src/stores/pos/shifts/services.ts", "TypeScript", 282, 0, 0, 0, 66, 49, 397
"/Users/peaker/dev/kitchen-app/backoffice/src/stores/pos/shifts/shiftsStore.ts", "TypeScript", 406, 0, 0, 0, 65, 71, 542
"/Users/peaker/dev/kitchen-app/backoffice/src/stores/pos/shifts/types.ts", "TypeScript", 191, 0, 0, 0, 108, 65, 364
"/Users/peaker/dev/kitchen-app/backoffice/src/stores/pos/tables/composables/useTables.ts", "TypeScript", 101, 0, 0, 0, 55, 23, 179
"/Users/peaker/dev/kitchen-app/backoffice/src/stores/pos/tables/services.ts", "TypeScript", 179, 0, 0, 0, 28, 31, 238
"/Users/peaker/dev/kitchen-app/backoffice/src/stores/pos/tables/tablesStore.ts", "TypeScript", 422, 0, 0, 0, 55, 52, 529
"/Users/peaker/dev/kitchen-app/backoffice/src/stores/pos/tables/types.ts", "TypeScript", 52, 0, 0, 0, 5, 13, 70
"/Users/peaker/dev/kitchen-app/backoffice/src/stores/pos/types.ts", "TypeScript", 306, 0, 0, 0, 16, 34, 356
"/Users/peaker/dev/kitchen-app/backoffice/src/stores/productsStore/index.ts", "TypeScript", -2, 0, 0, 0, -1, -2, -5
"/Users/peaker/dev/kitchen-app/backoffice/src/stores/productsStore/productsMock.ts", "TypeScript", -308, 0, 0, 0, -26, -25, -359
"/Users/peaker/dev/kitchen-app/backoffice/src/stores/productsStore/productsService.ts", "TypeScript", 112, 0, 0, 0, 17, 29, 158
"/Users/peaker/dev/kitchen-app/backoffice/src/stores/productsStore/productsStore.ts", "TypeScript", 401, 0, 0, 0, 58, 66, 525
"/Users/peaker/dev/kitchen-app/backoffice/src/stores/productsStore/types.ts", "TypeScript", 13, 0, 0, 0, -17, -6, -10
"/Users/peaker/dev/kitchen-app/backoffice/src/stores/recipes/composables/useCostCalculation.ts", "TypeScript", 6, 0, 0, 0, -5, -7, -6
"/Users/peaker/dev/kitchen-app/backoffice/src/stores/shared/mockDataCoordinator.ts", "TypeScript", 167, 0, 0, 0, 18, 17, 202
"/Users/peaker/dev/kitchen-app/backoffice/src/stores/shared/productDefinitions.ts", "TypeScript", 19, 0, 0, 0, 2, 1, 22
"/Users/peaker/dev/kitchen-app/backoffice/src/stores/shared/storageDefinitions.ts", "TypeScript", 27, 0, 0, 0, -1, -8, 18
"/Users/peaker/dev/kitchen-app/backoffice/src/stores/shared/supplierDefinitions.ts", "TypeScript", -46, 0, 0, 0, -15, -17, -78
"/Users/peaker/dev/kitchen-app/backoffice/src/stores/storage/storageService.ts", "TypeScript", 15, 0, 0, 0, 0, 0, 15
"/Users/peaker/dev/kitchen-app/backoffice/src/stores/storage/storageStore.ts", "TypeScript", -76, 0, 0, 0, 45, -7, -38
"/Users/peaker/dev/kitchen-app/backoffice/src/stores/storage/transitBatchService.ts", "TypeScript", 297, 0, 0, 0, 107, 78, 482
"/Users/peaker/dev/kitchen-app/backoffice/src/stores/storage/types.ts", "TypeScript", -1, 0, 0, 0, 0, 0, -1
"/Users/peaker/dev/kitchen-app/backoffice/src/stores/supplier_2/composables/usePurchaseOrders.ts", "TypeScript", 21, 0, 0, 0, 0, -1, 20
"/Users/peaker/dev/kitchen-app/backoffice/src/stores/supplier_2/composables/useReceipts.ts", "TypeScript", 22, 0, 0, 0, 4, 13, 39
"/Users/peaker/dev/kitchen-app/backoffice/src/stores/supplier_2/integrations/index.ts", "TypeScript", -13, 0, 0, 0, -14, -7, -34
"/Users/peaker/dev/kitchen-app/backoffice/src/stores/supplier_2/integrations/plannedDeliveryIntegration-copy.ts", "TypeScript", 167, 0, 0, 0, 84, 44, 295
"/Users/peaker/dev/kitchen-app/backoffice/src/stores/supplier_2/integrations/plannedDeliveryIntegration.ts", "TypeScript", -167, 0, 0, 0, -84, -44, -295
"/Users/peaker/dev/kitchen-app/backoffice/src/stores/supplier_2/integrations/storageIntegration.ts", "TypeScript", -31, 0, 0, 0, -47, -16, -94
"/Users/peaker/dev/kitchen-app/backoffice/src/stores/supplier_2/supplierService.ts", "TypeScript", 6, 0, 0, 0, 16, 19, 41
"/Users/peaker/dev/kitchen-app/backoffice/src/stores/supplier_2/supplierStore.ts", "TypeScript", 4, 0, 0, 0, -3, 1, 2
"/Users/peaker/dev/kitchen-app/backoffice/src/stores/supplier_2/types.ts", "TypeScript", 34, 0, 0, 0, 7, 9, 50
"/Users/peaker/dev/kitchen-app/backoffice/src/styles/main.scss", "SCSS", 0, 0, 372, 0, 53, 51, 476
"/Users/peaker/dev/kitchen-app/backoffice/src/styles/variables.scss", "SCSS", 0, 0, 142, 0, 45, 29, 216
"/Users/peaker/dev/kitchen-app/backoffice/src/types/auth.ts", "TypeScript", -38, 0, 0, 0, -1, -8, -47
"/Users/peaker/dev/kitchen-app/backoffice/src/utils/debugger.ts", "TypeScript", 283, 0, 0, 0, 47, 58, 388
"/Users/peaker/dev/kitchen-app/backoffice/src/utils/quantityFormatter.ts", "TypeScript", 0, 0, 0, 0, 1, 0, 1
"/Users/peaker/dev/kitchen-app/backoffice/src/views/LoginView.vue", "Vue", 0, -65, 0, 0, -1, -13, -79
"/Users/peaker/dev/kitchen-app/backoffice/src/views/NotFoundView.vue", "Vue", 0, 92, 0, 0, 5, 14, 111
"/Users/peaker/dev/kitchen-app/backoffice/src/views/auth/LoginView.vue", "Vue", 0, 222, 0, 0, 4, 53, 279
"/Users/peaker/dev/kitchen-app/backoffice/src/views/auth/UnauthorizedView.vue", "Vue", 0, 41, 0, 0, 1, 10, 52
"/Users/peaker/dev/kitchen-app/backoffice/src/views/pos/PosMainView.vue", "Vue", 0, 438, 0, 0, 8, 71, 517
"/Users/peaker/dev/kitchen-app/backoffice/src/views/pos/components/ConfirmDialog.vue", "Vue", 0, 111, 0, 0, 4, 18, 133
"/Users/peaker/dev/kitchen-app/backoffice/src/views/pos/components/PaymentDialog.vue", "Vue", 0, 289, 0, 0, 10, 50, 349
"/Users/peaker/dev/kitchen-app/backoffice/src/views/pos/components/PaymentSection.vue", "Vue", 0, 289, 0, 0, 10, 50, 349
"/Users/peaker/dev/kitchen-app/backoffice/src/views/pos/components/PosNavigationMenu.vue", "Vue", 0, 335, 0, 0, 7, 61, 403
"/Users/peaker/dev/kitchen-app/backoffice/src/views/pos/menu/MenuSection.vue", "Vue", 0, 331, 0, 0, 9, 48, 388
"/Users/peaker/dev/kitchen-app/backoffice/src/views/pos/menu/components/CategoryCard.vue", "Vue", 0, 174, 0, 0, 4, 37, 215
"/Users/peaker/dev/kitchen-app/backoffice/src/views/pos/menu/components/MenuItemCard.vue", "Vue", 0, 314, 0, 0, 8, 61, 383
"/Users/peaker/dev/kitchen-app/backoffice/src/views/pos/order/OrderSection.vue", "Vue", 0, 651, 0, 0, 13, 115, 779
"/Users/peaker/dev/kitchen-app/backoffice/src/views/pos/order/components/BillItem.vue", "Vue", 0, 550, 0, 0, 12, 101, 663
"/Users/peaker/dev/kitchen-app/backoffice/src/views/pos/order/components/BillsManager.vue", "Vue", 0, 268, 0, 0, 6, 49, 323
"/Users/peaker/dev/kitchen-app/backoffice/src/views/pos/order/components/BillsTabs.vue", "Vue", 0, 468, 0, 0, 13, 78, 559
"/Users/peaker/dev/kitchen-app/backoffice/src/views/pos/order/components/OrderActions.vue", "Vue", 0, 227, 0, 0, 8, 38, 273
"/Users/peaker/dev/kitchen-app/backoffice/src/views/pos/order/components/OrderInfo.vue", "Vue", 0, 296, 0, 0, 6, 67, 369
"/Users/peaker/dev/kitchen-app/backoffice/src/views/pos/order/components/OrderTotals.vue", "Vue", 0, 200, 0, 0, 10, 43, 253
"/Users/peaker/dev/kitchen-app/backoffice/src/views/pos/order/dialogs/BillDiscountDialog.vue", "Vue", 0, 66, 0, 0, 1, 10, 77
"/Users/peaker/dev/kitchen-app/backoffice/src/views/pos/order/dialogs/BillItemCancelDialog.vue", "Vue", 0, 47, 0, 0, 1, 7, 55
"/Users/peaker/dev/kitchen-app/backoffice/src/views/pos/order/dialogs/BillItemEditDialog.vue", "Vue", 0, 50, 0, 0, 1, 8, 59
"/Users/peaker/dev/kitchen-app/backoffice/src/views/pos/order/dialogs/BulkActionsDialog.vue", "Vue", 0, 141, 0, 0, 6, 17, 164
"/Users/peaker/dev/kitchen-app/backoffice/src/views/pos/order/dialogs/CheckoutDialog.vue", "Vue", 0, 131, 0, 0, 4, 16, 151
"/Users/peaker/dev/kitchen-app/backoffice/src/views/pos/order/dialogs/MoveItemsDialog.vue", "Vue", 0, 64, 0, 0, 1, 11, 76
"/Users/peaker/dev/kitchen-app/backoffice/src/views/pos/order/dialogs/OrderTypeDialog.vue", "Vue", 0, 77, 0, 0, 1, 12, 90
"/Users/peaker/dev/kitchen-app/backoffice/src/views/pos/shifts/dialogs/EndShiftDialog.vue", "Vue", 0, 445, 0, 0, 13, 74, 532
"/Users/peaker/dev/kitchen-app/backoffice/src/views/pos/shifts/dialogs/StartShiftDialog.vue", "Vue", 0, 258, 0, 0, 10, 48, 316
"/Users/peaker/dev/kitchen-app/backoffice/src/views/pos/tables/OrderItem.vue", "Vue", 0, 417, 0, 0, 7, 72, 496
"/Users/peaker/dev/kitchen-app/backoffice/src/views/pos/tables/TableItem.vue", "Vue", 0, 214, 0, 0, 3, 40, 257
"/Users/peaker/dev/kitchen-app/backoffice/src/views/pos/tables/TablesSidebar.vue", "Vue", 0, 482, 0, 0, 8, 86, 576
"/Users/peaker/dev/kitchen-app/backoffice/src/views/pos/tables/components/SidebarItem.vue", "Vue", 0, 396, 0, 0, 5, 76, 477
"/Users/peaker/dev/kitchen-app/backoffice/src/views/pos/tables/dialogs/OrderTypeDialog.vue", "Vue", 0, 204, 0, 0, 5, 41, 250
"/Users/peaker/dev/kitchen-app/backoffice/src/views/products/ProductsView.vue", "Vue", 0, 105, 0, 0, 0, 9, 114
"/Users/peaker/dev/kitchen-app/backoffice/src/views/products/components/ProductDetailsDialog.vue", "Vue", 0, 55, 0, 0, 1, 8, 64
"/Users/peaker/dev/kitchen-app/backoffice/src/views/products/components/ProductDialog.vue", "Vue", 0, 202, 0, 0, 6, 19, 227
"/Users/peaker/dev/kitchen-app/backoffice/src/views/products/components/ProductsFilters.vue", "Vue", 0, 53, 0, 0, 2, 6, 61
"/Users/peaker/dev/kitchen-app/backoffice/src/views/products/components/ProductsList.vue", "Vue", 0, 31, 0, 0, 1, 4, 36
"/Users/peaker/dev/kitchen-app/backoffice/src/views/products/components/package/PackageOptionDialog.vue", "Vue", 0, 292, 0, 0, 1, 33, 326
"/Users/peaker/dev/kitchen-app/backoffice/src/views/products/components/package/PackageOptionsList.vue", "Vue", 0, 112, 0, 0, 0, 14, 126
"/Users/peaker/dev/kitchen-app/backoffice/src/views/storage/StorageView.vue", "Vue", 0, 29, 0, 0, 0, 10, 39
"/Users/peaker/dev/kitchen-app/backoffice/src/views/storage/components/StorageStockTable.vue", "Vue", 0, 34, 0, 0, 0, 8, 42
"/Users/peaker/dev/kitchen-app/backoffice/src/views/supplier_2/components/orders/AttachBillDialog.vue", "Vue", 0, -324, 0, 0, -11, -55, -390
"/Users/peaker/dev/kitchen-app/backoffice/src/views/supplier_2/components/orders/BaseSupplierBaskets.vue", "Vue", 0, -182, 0, 0, -9, -12, -203
"/Users/peaker/dev/kitchen-app/backoffice/src/views/supplier_2/components/orders/OrderReceiptWidget.vue", "Vue", 0, -196, 0, 0, -4, -29, -229
"/Users/peaker/dev/kitchen-app/backoffice/src/views/supplier_2/components/orders/PurchaseOrderDetailsDialog.vue", "Vue", 0, -166, 0, 0, -4, -27, -197
"/Users/peaker/dev/kitchen-app/backoffice/src/views/supplier_2/components/orders/PurchaseOrderEditDialog.vue", "Vue", 0, -87, 0, 0, -4, 7, -84
"/Users/peaker/dev/kitchen-app/backoffice/src/views/supplier_2/components/orders/PurchaseOrderPayment.vue", "Vue", 0, -392, 0, 0, -14, -60, -466
"/Users/peaker/dev/kitchen-app/backoffice/src/views/supplier_2/components/orders/basket/SupplierBasketsWidget.vue", "Vue", 0, 175, 0, 0, 8, 27, 210
"/Users/peaker/dev/kitchen-app/backoffice/src/views/supplier_2/components/orders/basket/UnassignedItemsWidget.vue", "Vue", 0, 233, 0, 0, 7, 33, 273
"/Users/peaker/dev/kitchen-app/backoffice/src/views/supplier_2/components/orders/order-edit/EditableOrderItemsWidget.vue", "Vue", 0, 487, 0, 0, 17, 73, 577
"/Users/peaker/dev/kitchen-app/backoffice/src/views/supplier_2/components/orders/order/AttachBillDialog.vue", "Vue", 0, 324, 0, 0, 11, 55, 390
"/Users/peaker/dev/kitchen-app/backoffice/src/views/supplier_2/components/orders/order/OrderItemsWidget.vue", "Vue", 0, 241, 0, 0, 12, 30, 283
"/Users/peaker/dev/kitchen-app/backoffice/src/views/supplier_2/components/orders/order/OrderReceiptWidget.vue", "Vue", 0, 196, 0, 0, 4, 29, 229
"/Users/peaker/dev/kitchen-app/backoffice/src/views/supplier_2/components/orders/order/PurchaseOrderPayment.vue", "Vue", 0, 399, 0, 0, 14, 62, 475
"/Users/peaker/dev/kitchen-app/backoffice/src/views/supplier_2/components/procurement/RequestDetailsDialog.vue", "Vue", 0, -2, 0, 0, 2, 8, 8
"/Users/peaker/dev/kitchen-app/backoffice/src/views/supplier_2/components/receipts/BaseReceiptDialog.vue", "Vue", 0, -255, 0, 0, -6, -34, -295
"/Users/peaker/dev/kitchen-app/backoffice/src/views/supplier_2/components/receipts/receipt-edit/EditableReceiptItemsWidget.vue", "Vue", 0, 660, 0, 0, 17, 124, 801
"/Users/peaker/dev/kitchen-app/backoffice/src/views/supplier_2/components/shared/BaseOrderAssistant.vue", "Vue", 0, -502, 0, 0, -18, -85, -605
"/Users/peaker/dev/kitchen-app/backoffice/src/views/supplier_2/components/shared/ManualItemForm.vue", "Vue", 0, 347, 0, 0, 6, 55, 408
"/Users/peaker/dev/kitchen-app/backoffice/src/views/supplier_2/components/shared/RequestSummaryPanel.vue", "Vue", 0, 428, 0, 0, 8, 64, 500
"/Users/peaker/dev/kitchen-app/backoffice/src/views/supplier_2/components/shared/package/PackageSelector.vue", "Vue", 0, 518, 0, 0, 19, 75, 612
"/Users/peaker/dev/kitchen-app/backoffice/src/views/supplier_2/components/shared/package/QuickAddPackageDialog.vue", "Vue", 0, 291, 0, 0, 7, 47, 345
"Total", "-", 8842, 12638, 514, 4673, 2791, 5533, 34991