"filename", "language", "TypeScript", "XML", "Vue", "SCSS", "Markdown", "comment", "blank", "total"
"/Users/peaker/dev/kitchen-app/backoffice/src/About/BACKOFFICE/7_Packages.md", "Markdown", 0, 0, 0, 0, 259, 0, 79, 338
"/Users/peaker/dev/kitchen-app/backoffice/src/About/BACKOFFICE/8_Batches_ref.md", "Markdown", 0, 0, 0, 0, 400, 0, 189, 589
"/Users/peaker/dev/kitchen-app/backoffice/src/About/BACKOFFICE/9_1_Warehouse.md", "Markdown", 0, 0, 0, 0, 1041, 0, 278, 1319
"/Users/peaker/dev/kitchen-app/backoffice/src/About/BACKOFFICE/9_Department_Warehouse.md", "Markdown", 0, 0, 0, 0, 1225, 0, 387, 1612
"/Users/peaker/dev/kitchen-app/backoffice/src/About/Base/About.md", "Markdown", 0, 0, 0, 0, 23, 0, 7, 30
"/Users/peaker/dev/kitchen-app/backoffice/src/About/Base/ArchitecturApp.md", "Markdown", 0, 0, 0, 0, 384, 0, 102, 486
"/Users/peaker/dev/kitchen-app/backoffice/src/About/Base/MeasurementUnits.md", "Markdown", 0, 0, 0, 0, 724, 0, 228, 952
"/Users/peaker/dev/kitchen-app/backoffice/src/About/Base/Style.md", "Markdown", 0, 0, 0, 0, 96, 0, 31, 127
"/Users/peaker/dev/kitchen-app/backoffice/src/About/POS/0.main.md", "Markdown", 0, 0, 0, 0, 272, 0, 110, 382
"/Users/peaker/dev/kitchen-app/backoffice/src/About/POS/1.md", "Markdown", 0, 0, 0, 0, 160, 0, 61, 221
"/Users/peaker/dev/kitchen-app/backoffice/src/About/POS/2_перенос.md", "Markdown", 0, 0, 0, 0, 159, 0, 9, 168
"/Users/peaker/dev/kitchen-app/backoffice/src/About/POS/3_Shift.md", "Markdown", 0, 0, 0, 0, 292, 0, 76, 368
"/Users/peaker/dev/kitchen-app/backoffice/src/About/POS/4_WorkFlow.md", "Markdown", 0, 0, 0, 0, 42, 0, 21, 63
"/Users/peaker/dev/kitchen-app/backoffice/src/About/POS/5_OrderSection.md", "Markdown", 0, 0, 0, 0, 511, 0, 156, 667
"/Users/peaker/dev/kitchen-app/backoffice/src/About/POS/6_Repository.md", "Markdown", 0, 0, 0, 0, 36, 0, 18, 54
"/Users/peaker/dev/kitchen-app/backoffice/src/About/SCSS_MainGuide.md", "Markdown", 0, 0, 0, 0, 250, 0, 60, 310
"/Users/peaker/dev/kitchen-app/backoffice/src/About/Stage_4_account.md", "Markdown", 0, 0, 0, 0, 436, 0, 118, 554
"/Users/peaker/dev/kitchen-app/backoffice/src/App.vue", "Vue", 0, 0, 127, 0, 0, 3, 26, 156
"/Users/peaker/dev/kitchen-app/backoffice/src/assets/vue.svg", "XML", 0, 1, 0, 0, 0, 0, 0, 1
"/Users/peaker/dev/kitchen-app/backoffice/src/components/atoms/DatePicker.vue", "Vue", 0, 0, 157, 0, 0, 1, 17, 175
"/Users/peaker/dev/kitchen-app/backoffice/src/components/atoms/buttons/ActionButton.vue", "Vue", 0, 0, 58, 0, 0, 7, 9, 74
"/Users/peaker/dev/kitchen-app/backoffice/src/components/atoms/buttons/BaseButton.vue", "Vue", 0, 0, 128, 0, 0, 45, 21, 194
"/Users/peaker/dev/kitchen-app/backoffice/src/components/atoms/buttons/LogoutButton.vue", "Vue", 0, 0, 121, 0, 0, 3, 25, 149
"/Users/peaker/dev/kitchen-app/backoffice/src/components/atoms/buttons/MenuButton.vue", "Vue", 0, 0, 41, 0, 0, 7, 7, 55
"/Users/peaker/dev/kitchen-app/backoffice/src/components/atoms/dropdowns/BaseDropdown.vue", "Vue", 0, 0, 41, 0, 0, 7, 7, 55
"/Users/peaker/dev/kitchen-app/backoffice/src/components/atoms/feedback/AppNotification.vue", "Vue", 0, 0, 200, 0, 0, 1, 42, 243
"/Users/peaker/dev/kitchen-app/backoffice/src/components/atoms/indicators/NotificationBadge.vue", "Vue", 0, 0, 110, 0, 0, 7, 19, 136
"/Users/peaker/dev/kitchen-app/backoffice/src/components/atoms/indicators/StatusChip.vue", "Vue", 0, 0, 82, 0, 0, 7, 20, 109
"/Users/peaker/dev/kitchen-app/backoffice/src/components/atoms/inputs/PinInput.vue", "Vue", 0, 0, 197, 0, 0, 1, 46, 244
"/Users/peaker/dev/kitchen-app/backoffice/src/components/base/BaseDialog.vue", "Vue", 0, 0, 124, 0, 0, 0, 14, 138
"/Users/peaker/dev/kitchen-app/backoffice/src/components/index.ts", "TypeScript", 1, 0, 0, 0, 0, 0, 1, 2
"/Users/peaker/dev/kitchen-app/backoffice/src/components/molecules/DateRangePicker.vue", "Vue", 0, 0, 284, 0, 0, 3, 29, 316
"/Users/peaker/dev/kitchen-app/backoffice/src/components/molecules/navigation/ActionMenu.vue", "Vue", 0, 0, 134, 0, 0, 7, 24, 165
"/Users/peaker/dev/kitchen-app/backoffice/src/components/molecules/navigation/StatusBar.vue", "Vue", 0, 0, 72, 0, 0, 10, 15, 97
"/Users/peaker/dev/kitchen-app/backoffice/src/components/navigation/AlertsBadge.vue", "Vue", 0, 0, 132, 0, 0, 4, 22, 158
"/Users/peaker/dev/kitchen-app/backoffice/src/components/navigation/DebugStoresBadge.vue", "Vue", 0, 0, 54, 0, 0, 1, 13, 68
"/Users/peaker/dev/kitchen-app/backoffice/src/components/navigation/NavigationAccounts.vue", "Vue", 0, 0, 78, 0, 0, 1, 6, 85
"/Users/peaker/dev/kitchen-app/backoffice/src/components/navigation/NavigationMenu.vue", "Vue", 0, 0, 264, 0, 0, 45, 35, 344
"/Users/peaker/dev/kitchen-app/backoffice/src/components/navigation/StorageAlertsBadge.vue", "Vue", 0, 0, 46, 0, 0, 3, 9, 58
"/Users/peaker/dev/kitchen-app/backoffice/src/components/organisms/LazyList.vue", "Vue", 0, 0, 247, 0, 0, 13, 41, 301
"/Users/peaker/dev/kitchen-app/backoffice/src/components/payment-settings/PaymentMethodDialog.vue", "Vue", 0, 0, 85, 0, 0, 0, 11, 96
"/Users/peaker/dev/kitchen-app/backoffice/src/components/payment-settings/PaymentMethodList.vue", "Vue", 0, 0, 76, 0, 0, 0, 12, 88
"/Users/peaker/dev/kitchen-app/backoffice/src/components/payment-settings/TaxDialog.vue", "Vue", 0, 0, 84, 0, 0, 0, 8, 92
"/Users/peaker/dev/kitchen-app/backoffice/src/components/payment-settings/TaxList.vue", "Vue", 0, 0, 59, 0, 0, 0, 12, 71
"/Users/peaker/dev/kitchen-app/backoffice/src/composables/useDialogForm.ts", "TypeScript", 59, 0, 0, 0, 0, 6, 10, 75
"/Users/peaker/dev/kitchen-app/backoffice/src/composables/useLazyLoading.ts", "TypeScript", 249, 0, 0, 0, 0, 15, 50, 314
"/Users/peaker/dev/kitchen-app/backoffice/src/composables/useMeasurementUnits.ts", "TypeScript", 211, 0, 0, 0, 0, 82, 49, 342
"/Users/peaker/dev/kitchen-app/backoffice/src/composables/usePersistence.ts", "TypeScript", 205, 0, 0, 0, 0, 50, 45, 300
"/Users/peaker/dev/kitchen-app/backoffice/src/composables/usePlatform.ts", "TypeScript", 108, 0, 0, 0, 0, 42, 35, 185
"/Users/peaker/dev/kitchen-app/backoffice/src/composables/useVuetifyBreakpoints.ts", "TypeScript", 19, 0, 0, 0, 0, 4, 5, 28
"/Users/peaker/dev/kitchen-app/backoffice/src/config/environment.ts", "TypeScript", 148, 0, 0, 0, 0, 62, 37, 247
"/Users/peaker/dev/kitchen-app/backoffice/src/config/users.ts", "TypeScript", 66, 0, 0, 0, 0, 4, 8, 78
"/Users/peaker/dev/kitchen-app/backoffice/src/core/appInitializer.ts", "TypeScript", 409, 0, 0, 0, 0, 38, 98, 545
"/Users/peaker/dev/kitchen-app/backoffice/src/core/appInitializerTests.ts", "TypeScript", 443, 0, 0, 0, 0, 84, 93, 620
"/Users/peaker/dev/kitchen-app/backoffice/src/core/users.ts", "TypeScript", 59, 0, 0, 0, 0, 33, 15, 107
"/Users/peaker/dev/kitchen-app/backoffice/src/firebase/config.ts", "TypeScript", 33, 0, 0, 0, 0, 1, 11, 45
"/Users/peaker/dev/kitchen-app/backoffice/src/firebase/converters.ts", "TypeScript", 45, 0, 0, 0, 0, 1, 4, 50
"/Users/peaker/dev/kitchen-app/backoffice/src/firebase/services/base.service.ts", "TypeScript", 81, 0, 0, 0, 0, 1, 10, 92
"/Users/peaker/dev/kitchen-app/backoffice/src/layouts/AuthLayout.vue", "Vue", 0, 0, 23, 0, 0, 1, 4, 28
"/Users/peaker/dev/kitchen-app/backoffice/src/layouts/EmptyLayout.vue", "Vue", 0, 0, 12, 0, 0, 1, 3, 16
"/Users/peaker/dev/kitchen-app/backoffice/src/layouts/MainLayout.vue", "Vue", 0, 0, 32, 0, 0, 1, 7, 40
"/Users/peaker/dev/kitchen-app/backoffice/src/layouts/PosLayout.vue", "Vue", 0, 0, 107, 0, 0, 5, 18, 130
"/Users/peaker/dev/kitchen-app/backoffice/src/layouts/pos/index.ts", "TypeScript", 9, 0, 0, 0, 0, 4, 4, 17
"/Users/peaker/dev/kitchen-app/backoffice/src/layouts/pos/posConstants.ts", "TypeScript", 80, 0, 0, 0, 0, 4, 9, 93
"/Users/peaker/dev/kitchen-app/backoffice/src/layouts/pos/posTypes.ts", "TypeScript", 57, 0, 0, 0, 0, 1, 6, 64
"/Users/peaker/dev/kitchen-app/backoffice/src/layouts/pos/usePosLayout.ts", "TypeScript", 84, 0, 0, 0, 0, 17, 21, 122
"/Users/peaker/dev/kitchen-app/backoffice/src/main.ts", "TypeScript", 36, 0, 0, 0, 0, 12, 14, 62
"/Users/peaker/dev/kitchen-app/backoffice/src/plugins/vuetify.ts", "TypeScript", 101, 0, 0, 0, 0, 1, 2, 104
"/Users/peaker/dev/kitchen-app/backoffice/src/repositories/base/IRepository.ts", "TypeScript", 81, 0, 0, 0, 0, 113, 42, 236
"/Users/peaker/dev/kitchen-app/backoffice/src/repositories/base/LocalStorageRepository.ts", "TypeScript", 272, 0, 0, 0, 0, 19, 57, 348
"/Users/peaker/dev/kitchen-app/backoffice/src/repositories/base/ServiceResponse.ts", "TypeScript", 134, 0, 0, 0, 0, 69, 32, 235
"/Users/peaker/dev/kitchen-app/backoffice/src/repositories/base/index.ts", "TypeScript", 90, 0, 0, 0, 0, 25, 20, 135
"/Users/peaker/dev/kitchen-app/backoffice/src/router/guards/auth.guard.ts", "TypeScript", 118, 0, 0, 0, 0, 14, 12, 144
"/Users/peaker/dev/kitchen-app/backoffice/src/router/index.ts", "TypeScript", 234, 0, 0, 0, 0, 29, 22, 285
"/Users/peaker/dev/kitchen-app/backoffice/src/router/types.ts", "TypeScript", 15, 0, 0, 0, 0, 1, 4, 20
"/Users/peaker/dev/kitchen-app/backoffice/src/services/auth.service.ts", "TypeScript", 80, 0, 0, 0, 0, 2, 18, 100
"/Users/peaker/dev/kitchen-app/backoffice/src/services/index.ts", "TypeScript", 1, 0, 0, 0, 0, 0, 1, 2
"/Users/peaker/dev/kitchen-app/backoffice/src/services/payment-method.service.ts", "TypeScript", 20, 0, 0, 0, 0, 1, 5, 26
"/Users/peaker/dev/kitchen-app/backoffice/src/services/session.service.ts", "TypeScript", 96, 0, 0, 0, 0, 2, 21, 119
"/Users/peaker/dev/kitchen-app/backoffice/src/services/tax.service.ts", "TypeScript", 20, 0, 0, 0, 0, 1, 5, 26
"/Users/peaker/dev/kitchen-app/backoffice/src/stores/account/accountBasedMock.ts", "TypeScript", 434, 0, 0, 0, 0, 28, 27, 489
"/Users/peaker/dev/kitchen-app/backoffice/src/stores/account/composables/useAccountTransactions.ts", "TypeScript", 251, 0, 0, 0, 0, 41, 63, 355
"/Users/peaker/dev/kitchen-app/backoffice/src/stores/account/index.ts", "TypeScript", 45, 0, 0, 0, 0, 8, 7, 60
"/Users/peaker/dev/kitchen-app/backoffice/src/stores/account/mock.ts", "TypeScript", 796, 0, 0, 0, 0, 7, 45, 848
"/Users/peaker/dev/kitchen-app/backoffice/src/stores/account/paymentMock.ts", "TypeScript", 429, 0, 0, 0, 0, 44, 67, 540
"/Users/peaker/dev/kitchen-app/backoffice/src/stores/account/service.ts", "TypeScript", 599, 0, 0, 0, 0, 43, 125, 767
"/Users/peaker/dev/kitchen-app/backoffice/src/stores/account/store.ts", "TypeScript", 735, 0, 0, 0, 0, 94, 168, 997
"/Users/peaker/dev/kitchen-app/backoffice/src/stores/account/types.ts", "TypeScript", 292, 0, 0, 0, 0, 17, 46, 355
"/Users/peaker/dev/kitchen-app/backoffice/src/stores/auth/authStore.ts", "TypeScript", 169, 0, 0, 0, 0, 28, 36, 233
"/Users/peaker/dev/kitchen-app/backoffice/src/stores/auth/composables/index.ts", "TypeScript", 2, 0, 0, 0, 0, 4, 2, 8
"/Users/peaker/dev/kitchen-app/backoffice/src/stores/auth/composables/useAuth.ts", "TypeScript", 59, 0, 0, 0, 0, 21, 15, 95
"/Users/peaker/dev/kitchen-app/backoffice/src/stores/auth/composables/usePermissions.ts", "TypeScript", 39, 0, 0, 0, 0, 19, 15, 73
"/Users/peaker/dev/kitchen-app/backoffice/src/stores/auth/index.ts", "TypeScript", 3, 0, 0, 0, 0, 0, 1, 4
"/Users/peaker/dev/kitchen-app/backoffice/src/stores/auth/services/index.ts", "TypeScript", 1, 0, 0, 0, 0, 4, 2, 7
"/Users/peaker/dev/kitchen-app/backoffice/src/stores/auth/services/session.service.ts", "TypeScript", 181, 0, 0, 0, 0, 43, 36, 260
"/Users/peaker/dev/kitchen-app/backoffice/src/stores/auth/types.ts", "TypeScript", 211, 0, 0, 0, 0, 48, 54, 313
"/Users/peaker/dev/kitchen-app/backoffice/src/stores/counteragents/composables/useCounteragentBalance.ts", "TypeScript", 76, 0, 0, 0, 0, 30, 17, 123
"/Users/peaker/dev/kitchen-app/backoffice/src/stores/counteragents/counteragentsService.ts", "TypeScript", 467, 0, 0, 0, 0, 43, 114, 624
"/Users/peaker/dev/kitchen-app/backoffice/src/stores/counteragents/counteragentsStore.ts", "TypeScript", 523, 0, 0, 0, 0, 87, 127, 737
"/Users/peaker/dev/kitchen-app/backoffice/src/stores/counteragents/index.ts", "TypeScript", 167, 0, 0, 0, 0, 20, 34, 221
"/Users/peaker/dev/kitchen-app/backoffice/src/stores/counteragents/integrations/automatedPayments.ts", "TypeScript", 218, 0, 0, 0, 0, 51, 61, 330
"/Users/peaker/dev/kitchen-app/backoffice/src/stores/counteragents/mock/counteragentsMock.ts", "TypeScript", 347, 0, 0, 0, 0, 74, 33, 454
"/Users/peaker/dev/kitchen-app/backoffice/src/stores/counteragents/services/balanceCorrectionService.ts", "TypeScript", 219, 0, 0, 0, 0, 33, 40, 292
"/Users/peaker/dev/kitchen-app/backoffice/src/stores/counteragents/types.ts", "TypeScript", 203, 0, 0, 0, 0, 56, 47, 306
"/Users/peaker/dev/kitchen-app/backoffice/src/stores/debug/composables/useDebugFormatting.ts", "TypeScript", 282, 0, 0, 0, 0, 75, 43, 400
"/Users/peaker/dev/kitchen-app/backoffice/src/stores/debug/composables/useDebugStores.ts", "TypeScript", 164, 0, 0, 0, 0, 93, 42, 299
"/Users/peaker/dev/kitchen-app/backoffice/src/stores/debug/debugService.ts", "TypeScript", 1356, 0, 0, 0, 0, 122, 201, 1679
"/Users/peaker/dev/kitchen-app/backoffice/src/stores/debug/debugStore.ts", "TypeScript", 358, 0, 0, 0, 0, 88, 80, 526
"/Users/peaker/dev/kitchen-app/backoffice/src/stores/debug/index.ts", "TypeScript", 23, 0, 0, 0, 0, 6, 6, 35
"/Users/peaker/dev/kitchen-app/backoffice/src/stores/debug/types.ts", "TypeScript", 221, 0, 0, 0, 0, 38, 40, 299
"/Users/peaker/dev/kitchen-app/backoffice/src/stores/menu/index.ts", "TypeScript", 42, 0, 0, 0, 0, 8, 7, 57
"/Users/peaker/dev/kitchen-app/backoffice/src/stores/menu/menuMock.ts", "TypeScript", 578, 0, 0, 0, 0, 59, 23, 660
"/Users/peaker/dev/kitchen-app/backoffice/src/stores/menu/menuService.ts", "TypeScript", 345, 0, 0, 0, 0, 34, 55, 434
"/Users/peaker/dev/kitchen-app/backoffice/src/stores/menu/menuStore.ts", "TypeScript", 321, 0, 0, 0, 0, 28, 59, 408
"/Users/peaker/dev/kitchen-app/backoffice/src/stores/menu/types.ts", "TypeScript", 194, 0, 0, 0, 0, 35, 42, 271
"/Users/peaker/dev/kitchen-app/backoffice/src/stores/payment-settings.store.ts", "TypeScript", 147, 0, 0, 0, 0, 4, 27, 178
"/Users/peaker/dev/kitchen-app/backoffice/src/stores/pos/core/posSystem.ts", "TypeScript", 78, 0, 0, 0, 0, 37, 21, 136
"/Users/peaker/dev/kitchen-app/backoffice/src/stores/pos/index.ts", "TypeScript", 255, 0, 0, 0, 0, 54, 56, 365
"/Users/peaker/dev/kitchen-app/backoffice/src/stores/pos/mocks/posMockData.ts", "TypeScript", 258, 0, 0, 0, 0, 25, 13, 296
"/Users/peaker/dev/kitchen-app/backoffice/src/stores/pos/orders/composables.ts", "TypeScript", 264, 0, 0, 0, 0, 92, 47, 403
"/Users/peaker/dev/kitchen-app/backoffice/src/stores/pos/orders/composables/useOrderCalculations.ts", "TypeScript", 216, 0, 0, 0, 0, 106, 53, 375
"/Users/peaker/dev/kitchen-app/backoffice/src/stores/pos/orders/composables/useOrders.ts", "TypeScript", 172, 0, 0, 0, 0, 69, 39, 280
"/Users/peaker/dev/kitchen-app/backoffice/src/stores/pos/orders/ordersStore.ts", "TypeScript", 641, 0, 0, 0, 0, 125, 120, 886
"/Users/peaker/dev/kitchen-app/backoffice/src/stores/pos/orders/services.ts", "TypeScript", 552, 0, 0, 0, 0, 39, 91, 682
"/Users/peaker/dev/kitchen-app/backoffice/src/stores/pos/payments/composables.ts", "TypeScript", 144, 0, 0, 0, 0, 46, 22, 212
"/Users/peaker/dev/kitchen-app/backoffice/src/stores/pos/payments/paymentsStore.ts", "TypeScript", 327, 0, 0, 0, 0, 82, 71, 480
"/Users/peaker/dev/kitchen-app/backoffice/src/stores/pos/payments/services.ts", "TypeScript", 132, 0, 0, 0, 0, 8, 25, 165
"/Users/peaker/dev/kitchen-app/backoffice/src/stores/pos/service/DepartmentNotificationService.ts", "TypeScript", 267, 0, 0, 0, 0, 60, 58, 385
"/Users/peaker/dev/kitchen-app/backoffice/src/stores/pos/shifts/composables.ts", "TypeScript", 273, 0, 0, 0, 0, 91, 58, 422
"/Users/peaker/dev/kitchen-app/backoffice/src/stores/pos/shifts/index.ts", "TypeScript", 5, 0, 0, 0, 0, 239, 18, 262
"/Users/peaker/dev/kitchen-app/backoffice/src/stores/pos/shifts/mock.ts", "TypeScript", 356, 0, 0, 0, 0, 51, 54, 461
"/Users/peaker/dev/kitchen-app/backoffice/src/stores/pos/shifts/services.ts", "TypeScript", 282, 0, 0, 0, 0, 66, 49, 397
"/Users/peaker/dev/kitchen-app/backoffice/src/stores/pos/shifts/shiftsStore.ts", "TypeScript", 406, 0, 0, 0, 0, 65, 71, 542
"/Users/peaker/dev/kitchen-app/backoffice/src/stores/pos/shifts/types.ts", "TypeScript", 191, 0, 0, 0, 0, 108, 65, 364
"/Users/peaker/dev/kitchen-app/backoffice/src/stores/pos/tables/composables/useTables.ts", "TypeScript", 101, 0, 0, 0, 0, 55, 23, 179
"/Users/peaker/dev/kitchen-app/backoffice/src/stores/pos/tables/services.ts", "TypeScript", 179, 0, 0, 0, 0, 28, 31, 238
"/Users/peaker/dev/kitchen-app/backoffice/src/stores/pos/tables/tablesStore.ts", "TypeScript", 422, 0, 0, 0, 0, 55, 52, 529
"/Users/peaker/dev/kitchen-app/backoffice/src/stores/pos/tables/types.ts", "TypeScript", 52, 0, 0, 0, 0, 5, 13, 70
"/Users/peaker/dev/kitchen-app/backoffice/src/stores/pos/types.ts", "TypeScript", 306, 0, 0, 0, 0, 16, 34, 356
"/Users/peaker/dev/kitchen-app/backoffice/src/stores/preparation/composables/usePreparationWriteOff.ts", "TypeScript", 383, 0, 0, 0, 0, 82, 63, 528
"/Users/peaker/dev/kitchen-app/backoffice/src/stores/preparation/index.ts", "TypeScript", 40, 0, 0, 0, 0, 13, 7, 60
"/Users/peaker/dev/kitchen-app/backoffice/src/stores/preparation/preparationMock.ts", "TypeScript", 253, 0, 0, 0, 0, 18, 32, 303
"/Users/peaker/dev/kitchen-app/backoffice/src/stores/preparation/preparationService.ts", "TypeScript", 925, 0, 0, 0, 0, 55, 162, 1142
"/Users/peaker/dev/kitchen-app/backoffice/src/stores/preparation/preparationStore.ts", "TypeScript", 555, 0, 0, 0, 0, 61, 113, 729
"/Users/peaker/dev/kitchen-app/backoffice/src/stores/preparation/types.ts", "TypeScript", 319, 0, 0, 0, 0, 20, 30, 369
"/Users/peaker/dev/kitchen-app/backoffice/src/stores/productsStore/composables/index.ts", "TypeScript", 4, 0, 0, 0, 0, 3, 3, 10
"/Users/peaker/dev/kitchen-app/backoffice/src/stores/productsStore/composables/useProductConsumption.ts", "TypeScript", 251, 0, 0, 0, 0, 30, 54, 335
"/Users/peaker/dev/kitchen-app/backoffice/src/stores/productsStore/composables/useProductPriceHistory.ts", "TypeScript", 298, 0, 0, 0, 0, 43, 60, 401
"/Users/peaker/dev/kitchen-app/backoffice/src/stores/productsStore/composables/useProductUsage.ts", "TypeScript", 389, 0, 0, 0, 0, 33, 69, 491
"/Users/peaker/dev/kitchen-app/backoffice/src/stores/productsStore/composables/useStockRecommendations.ts", "TypeScript", 253, 0, 0, 0, 0, 26, 47, 326
"/Users/peaker/dev/kitchen-app/backoffice/src/stores/productsStore/index.ts", "TypeScript", 11, 0, 0, 0, 0, 5, 5, 21
"/Users/peaker/dev/kitchen-app/backoffice/src/stores/productsStore/productsService.ts", "TypeScript", 236, 0, 0, 0, 0, 46, 49, 331
"/Users/peaker/dev/kitchen-app/backoffice/src/stores/productsStore/productsStore.ts", "TypeScript", 756, 0, 0, 0, 0, 113, 148, 1017
"/Users/peaker/dev/kitchen-app/backoffice/src/stores/productsStore/types.ts", "TypeScript", 298, 0, 0, 0, 0, 32, 54, 384
"/Users/peaker/dev/kitchen-app/backoffice/src/stores/recipes/composables/useCostCalculation.ts", "TypeScript", 556, 0, 0, 0, 0, 79, 117, 752
"/Users/peaker/dev/kitchen-app/backoffice/src/stores/recipes/composables/useMenuRecipeLinks.ts", "TypeScript", 145, 0, 0, 0, 0, 51, 37, 233
"/Users/peaker/dev/kitchen-app/backoffice/src/stores/recipes/composables/usePreparations.ts", "TypeScript", 360, 0, 0, 0, 0, 105, 81, 546
"/Users/peaker/dev/kitchen-app/backoffice/src/stores/recipes/composables/useRecipeIntegration.ts", "TypeScript", 186, 0, 0, 0, 0, 65, 55, 306
"/Users/peaker/dev/kitchen-app/backoffice/src/stores/recipes/composables/useRecipes.ts", "TypeScript", 523, 0, 0, 0, 0, 132, 115, 770
"/Users/peaker/dev/kitchen-app/backoffice/src/stores/recipes/composables/useUnits.ts", "TypeScript", 83, 0, 0, 0, 0, 53, 34, 170
"/Users/peaker/dev/kitchen-app/backoffice/src/stores/recipes/index.ts", "TypeScript", 6, 0, 0, 0, 0, 2, 2, 10
"/Users/peaker/dev/kitchen-app/backoffice/src/stores/recipes/recipesMock.ts", "TypeScript", 520, 0, 0, 0, 0, 24, 29, 573
"/Users/peaker/dev/kitchen-app/backoffice/src/stores/recipes/recipesService.ts", "TypeScript", 257, 0, 0, 0, 0, 22, 59, 338
"/Users/peaker/dev/kitchen-app/backoffice/src/stores/recipes/recipesStore.ts", "TypeScript", 421, 0, 0, 0, 0, 85, 109, 615
"/Users/peaker/dev/kitchen-app/backoffice/src/stores/recipes/types.ts", "TypeScript", 318, 0, 0, 0, 0, 95, 69, 482
"/Users/peaker/dev/kitchen-app/backoffice/src/stores/recipes/unitsMock.ts", "TypeScript", 24, 0, 0, 0, 0, 3, 6, 33
"/Users/peaker/dev/kitchen-app/backoffice/src/stores/shared/index.ts", "TypeScript", 31, 0, 0, 0, 0, 13, 12, 56
"/Users/peaker/dev/kitchen-app/backoffice/src/stores/shared/mockDataCoordinator.ts", "TypeScript", 669, 0, 0, 0, 0, 83, 131, 883
"/Users/peaker/dev/kitchen-app/backoffice/src/stores/shared/productDefinitions.ts", "TypeScript", 503, 0, 0, 0, 0, 73, 119, 695
"/Users/peaker/dev/kitchen-app/backoffice/src/stores/shared/storageDefinitions.ts", "TypeScript", 604, 0, 0, 0, 0, 129, 126, 859
"/Users/peaker/dev/kitchen-app/backoffice/src/stores/shared/supplierDefinitions.ts", "TypeScript", 1026, 0, 0, 0, 0, 54, 101, 1181
"/Users/peaker/dev/kitchen-app/backoffice/src/stores/storage/composables/useWriteOff.ts", "TypeScript", 440, 0, 0, 0, 0, 95, 77, 612
"/Users/peaker/dev/kitchen-app/backoffice/src/stores/storage/index.ts", "TypeScript", 34, 0, 0, 0, 0, 5, 5, 44
"/Users/peaker/dev/kitchen-app/backoffice/src/stores/storage/storageService.ts", "TypeScript", 1054, 0, 0, 0, 0, 94, 192, 1340
"/Users/peaker/dev/kitchen-app/backoffice/src/stores/storage/storageStore.ts", "TypeScript", 616, 0, 0, 0, 0, 100, 148, 864
"/Users/peaker/dev/kitchen-app/backoffice/src/stores/storage/transitBatchService.ts", "TypeScript", 297, 0, 0, 0, 0, 107, 78, 482
"/Users/peaker/dev/kitchen-app/backoffice/src/stores/storage/types.ts", "TypeScript", 310, 0, 0, 0, 0, 19, 36, 365
"/Users/peaker/dev/kitchen-app/backoffice/src/stores/supplier_2/__tests__/supplierIntegration.test.ts", "TypeScript", 363, 0, 0, 0, 0, 22, 55, 440
"/Users/peaker/dev/kitchen-app/backoffice/src/stores/supplier_2/composables/useOrderAssistant.ts", "TypeScript", 506, 0, 0, 0, 0, 137, 107, 750
"/Users/peaker/dev/kitchen-app/backoffice/src/stores/supplier_2/composables/useOrderPayments.ts", "TypeScript", 561, 0, 0, 0, 0, 124, 138, 823
"/Users/peaker/dev/kitchen-app/backoffice/src/stores/supplier_2/composables/useProcurementRequests.ts", "TypeScript", 317, 0, 0, 0, 0, 113, 65, 495
"/Users/peaker/dev/kitchen-app/backoffice/src/stores/supplier_2/composables/usePurchaseOrders.ts", "TypeScript", 783, 0, 0, 0, 0, 250, 178, 1211
"/Users/peaker/dev/kitchen-app/backoffice/src/stores/supplier_2/composables/useReceipts.ts", "TypeScript", 720, 0, 0, 0, 0, 166, 153, 1039
"/Users/peaker/dev/kitchen-app/backoffice/src/stores/supplier_2/index.ts", "TypeScript", 133, 0, 0, 0, 0, 51, 37, 221
"/Users/peaker/dev/kitchen-app/backoffice/src/stores/supplier_2/integrations/accountIntegration.ts", "TypeScript", 357, 0, 0, 0, 0, 40, 67, 464
"/Users/peaker/dev/kitchen-app/backoffice/src/stores/supplier_2/integrations/index.ts", "TypeScript", 4, 0, 0, 0, 0, 1, 2, 7
"/Users/peaker/dev/kitchen-app/backoffice/src/stores/supplier_2/integrations/plannedDeliveryIntegration-copy.ts", "TypeScript", 167, 0, 0, 0, 0, 84, 44, 295
"/Users/peaker/dev/kitchen-app/backoffice/src/stores/supplier_2/integrations/storageIntegration.ts", "TypeScript", 397, 0, 0, 0, 0, 6, 83, 486
"/Users/peaker/dev/kitchen-app/backoffice/src/stores/supplier_2/supplierService.ts", "TypeScript", 789, 0, 0, 0, 0, 87, 175, 1051
"/Users/peaker/dev/kitchen-app/backoffice/src/stores/supplier_2/supplierStore.ts", "TypeScript", 1301, 0, 0, 0, 0, 77, 255, 1633
"/Users/peaker/dev/kitchen-app/backoffice/src/stores/supplier_2/types.ts", "TypeScript", 393, 0, 0, 0, 0, 65, 89, 547
"/Users/peaker/dev/kitchen-app/backoffice/src/stores/supplier_2/types/supplierIntegrationTypes.ts", "TypeScript", 163, 0, 0, 0, 0, 82, 33, 278
"/Users/peaker/dev/kitchen-app/backoffice/src/styles/main.scss", "SCSS", 0, 0, 0, 387, 0, 56, 55, 498
"/Users/peaker/dev/kitchen-app/backoffice/src/styles/variables.scss", "SCSS", 0, 0, 0, 167, 0, 47, 33, 247
"/Users/peaker/dev/kitchen-app/backoffice/src/types/bill.ts", "TypeScript", 29, 0, 0, 0, 0, 1, 4, 34
"/Users/peaker/dev/kitchen-app/backoffice/src/types/common.ts", "TypeScript", 8, 0, 0, 0, 0, 1, 1, 10
"/Users/peaker/dev/kitchen-app/backoffice/src/types/customer.ts", "TypeScript", 7, 0, 0, 0, 0, 1, 1, 9
"/Users/peaker/dev/kitchen-app/backoffice/src/types/index.ts", "TypeScript", 7, 0, 0, 0, 0, 1, 1, 9
"/Users/peaker/dev/kitchen-app/backoffice/src/types/measurementUnits.ts", "TypeScript", 211, 0, 0, 0, 0, 58, 35, 304
"/Users/peaker/dev/kitchen-app/backoffice/src/types/payment.ts", "TypeScript", 22, 0, 0, 0, 0, 1, 4, 27
"/Users/peaker/dev/kitchen-app/backoffice/src/types/scss.d.ts", "TypeScript", 15, 0, 0, 0, 0, 1, 1, 17
"/Users/peaker/dev/kitchen-app/backoffice/src/types/settings.ts", "TypeScript", 23, 0, 0, 0, 0, 1, 3, 27
"/Users/peaker/dev/kitchen-app/backoffice/src/types/tax.ts", "TypeScript", 6, 0, 0, 0, 0, 1, 2, 9
"/Users/peaker/dev/kitchen-app/backoffice/src/utils/currency.ts", "TypeScript", 173, 0, 0, 0, 0, 121, 53, 347
"/Users/peaker/dev/kitchen-app/backoffice/src/utils/debugger.ts", "TypeScript", 370, 0, 0, 0, 0, 49, 77, 496
"/Users/peaker/dev/kitchen-app/backoffice/src/utils/formatter.ts", "TypeScript", 96, 0, 0, 0, 0, 40, 25, 161
"/Users/peaker/dev/kitchen-app/backoffice/src/utils/id.ts", "TypeScript", 16, 0, 0, 0, 0, 12, 4, 32
"/Users/peaker/dev/kitchen-app/backoffice/src/utils/index.ts", "TypeScript", 5, 0, 0, 0, 0, 1, 1, 7
"/Users/peaker/dev/kitchen-app/backoffice/src/utils/quantityFormatter.ts", "TypeScript", 181, 0, 0, 0, 0, 53, 43, 277
"/Users/peaker/dev/kitchen-app/backoffice/src/utils/time.ts", "TypeScript", 313, 0, 0, 0, 0, 93, 53, 459
"/Users/peaker/dev/kitchen-app/backoffice/src/views/NotFoundView.vue", "Vue", 0, 0, 120, 0, 0, 5, 19, 144
"/Users/peaker/dev/kitchen-app/backoffice/src/views/PaymentSettingsView.vue", "Vue", 0, 0, 108, 0, 0, 4, 20, 132
"/Users/peaker/dev/kitchen-app/backoffice/src/views/Preparation/PreparationView.vue", "Vue", 0, 0, 511, 0, 0, 16, 80, 607
"/Users/peaker/dev/kitchen-app/backoffice/src/views/Preparation/components/AddPreparationProductionItemDialog.vue", "Vue", 0, 0, 124, 0, 0, 5, 21, 150
"/Users/peaker/dev/kitchen-app/backoffice/src/views/Preparation/components/InventoryDetailsDialog.vue", "Vue", 0, 0, 633, 0, 0, 18, 66, 717
"/Users/peaker/dev/kitchen-app/backoffice/src/views/Preparation/components/PreparationAlerts.vue", "Vue", 0, 0, 92, 0, 0, 2, 14, 108
"/Users/peaker/dev/kitchen-app/backoffice/src/views/Preparation/components/PreparationInventoriesTable.vue", "Vue", 0, 0, 478, 0, 0, 19, 61, 558
"/Users/peaker/dev/kitchen-app/backoffice/src/views/Preparation/components/PreparationInventoryDialog.vue", "Vue", 0, 0, 475, 0, 0, 9, 74, 558
"/Users/peaker/dev/kitchen-app/backoffice/src/views/Preparation/components/PreparationInventoryItemRow.vue", "Vue", 0, 0, 325, 0, 0, 10, 42, 377
"/Users/peaker/dev/kitchen-app/backoffice/src/views/Preparation/components/PreparationItemDetailsDialog.vue", "Vue", 0, 0, 450, 0, 0, 9, 50, 509
"/Users/peaker/dev/kitchen-app/backoffice/src/views/Preparation/components/PreparationOperationsTable.vue", "Vue", 0, 0, 669, 0, 0, 27, 69, 765
"/Users/peaker/dev/kitchen-app/backoffice/src/views/Preparation/components/PreparationProductionDialog.vue", "Vue", 0, 0, 228, 0, 0, 9, 39, 276
"/Users/peaker/dev/kitchen-app/backoffice/src/views/Preparation/components/PreparationProductionItemCard.vue", "Vue", 0, 0, 185, 0, 0, 6, 23, 214
"/Users/peaker/dev/kitchen-app/backoffice/src/views/Preparation/components/PreparationStockTable.vue", "Vue", 0, 0, 671, 0, 0, 22, 84, 777
"/Users/peaker/dev/kitchen-app/backoffice/src/views/Preparation/components/index.ts", "TypeScript", 11, 0, 0, 0, 0, 124, 19, 154
"/Users/peaker/dev/kitchen-app/backoffice/src/views/Preparation/components/writeoff/PreparationQuantityDialog.vue", "Vue", 0, 0, 479, 0, 0, 8, 75, 562
"/Users/peaker/dev/kitchen-app/backoffice/src/views/Preparation/components/writeoff/PreparationSelectorWidget.vue", "Vue", 0, 0, 324, 0, 0, 7, 55, 386
"/Users/peaker/dev/kitchen-app/backoffice/src/views/Preparation/components/writeoff/PreparationWriteOffDialog.vue", "Vue", 0, 0, 510, 0, 0, 20, 64, 594
"/Users/peaker/dev/kitchen-app/backoffice/src/views/Preparation/components/writeoff/PreparationWriteOffWidget.vue", "Vue", 0, 0, 81, 0, 0, 5, 16, 102
"/Users/peaker/dev/kitchen-app/backoffice/src/views/accounts/AccountDetailView.vue", "Vue", 0, 0, 604, 0, 0, 16, 86, 706
"/Users/peaker/dev/kitchen-app/backoffice/src/views/accounts/AccountListView.vue", "Vue", 0, 0, 126, 0, 0, 2, 22, 150
"/Users/peaker/dev/kitchen-app/backoffice/src/views/accounts/components/detail/AccountOperations.vue", "Vue", 0, 0, 173, 0, 0, 0, 20, 193
"/Users/peaker/dev/kitchen-app/backoffice/src/views/accounts/components/detail/AccountOperationsFilter.vue", "Vue", 0, 0, 121, 0, 0, 0, 21, 142
"/Users/peaker/dev/kitchen-app/backoffice/src/views/accounts/components/dialogs/AccountDialog.vue", "Vue", 0, 0, 173, 0, 0, 0, 19, 192
"/Users/peaker/dev/kitchen-app/backoffice/src/views/accounts/components/dialogs/CorrectionDialog.vue", "Vue", 0, 0, 153, 0, 0, 4, 20, 177
"/Users/peaker/dev/kitchen-app/backoffice/src/views/accounts/components/dialogs/OperationDialog.vue", "Vue", 0, 0, 179, 0, 0, 2, 20, 201
"/Users/peaker/dev/kitchen-app/backoffice/src/views/accounts/components/dialogs/PaymentDialog.vue", "Vue", 0, 0, 650, 0, 0, 20, 86, 756
"/Users/peaker/dev/kitchen-app/backoffice/src/views/accounts/components/dialogs/TransactionDetailDialog.vue", "Vue", 0, 0, 56, 0, 0, 4, 14, 74
"/Users/peaker/dev/kitchen-app/backoffice/src/views/accounts/components/dialogs/TransferDialog.vue", "Vue", 0, 0, 114, 0, 0, 0, 9, 123
"/Users/peaker/dev/kitchen-app/backoffice/src/views/accounts/components/dialogs/transaction-detail/SupplierPaymentContextWidget.vue", "Vue", 0, 0, 214, 0, 0, 6, 37, 257
"/Users/peaker/dev/kitchen-app/backoffice/src/views/accounts/components/dialogs/transaction-detail/TransactionDetailContent.vue", "Vue", 0, 0, 140, 0, 0, 7, 25, 172
"/Users/peaker/dev/kitchen-app/backoffice/src/views/accounts/components/list/AccountList.vue", "Vue", 0, 0, 195, 0, 0, 3, 25, 223
"/Users/peaker/dev/kitchen-app/backoffice/src/views/accounts/components/list/AccountListToolbar.vue", "Vue", 0, 0, 46, 0, 0, 0, 8, 54
"/Users/peaker/dev/kitchen-app/backoffice/src/views/accounts/components/list/PaymentConfirmationDialog.vue", "Vue", 0, 0, 302, 0, 0, 4, 46, 352
"/Users/peaker/dev/kitchen-app/backoffice/src/views/accounts/components/list/PendingPaymentsWidget.vue", "Vue", 0, 0, 195, 0, 0, 5, 32, 232
"/Users/peaker/dev/kitchen-app/backoffice/src/views/auth/LoginView.vue", "Vue", 0, 0, 222, 0, 0, 4, 53, 279
"/Users/peaker/dev/kitchen-app/backoffice/src/views/auth/UnauthorizedView.vue", "Vue", 0, 0, 41, 0, 0, 1, 10, 52
"/Users/peaker/dev/kitchen-app/backoffice/src/views/counteragents/CounteragentsView.vue", "Vue", 0, 0, 293, 0, 0, 13, 48, 354
"/Users/peaker/dev/kitchen-app/backoffice/src/views/counteragents/components/counteragents/CounteragentCard.vue", "Vue", 0, 0, 177, 0, 0, 10, 29, 216
"/Users/peaker/dev/kitchen-app/backoffice/src/views/counteragents/components/counteragents/CounteragentCardContent.vue", "Vue", 0, 0, 554, 0, 0, 15, 73, 642
"/Users/peaker/dev/kitchen-app/backoffice/src/views/counteragents/components/counteragents/CounteragentDialog.vue", "Vue", 0, 0, 636, 0, 0, 12, 70, 718
"/Users/peaker/dev/kitchen-app/backoffice/src/views/counteragents/components/counteragents/CounteragentFilters.vue", "Vue", 0, 0, 417, 0, 0, 11, 50, 478
"/Users/peaker/dev/kitchen-app/backoffice/src/views/counteragents/components/counteragents/CounteragentPaymentsSimple.vue", "Vue", 0, 0, 702, 0, 0, 10, 124, 836
"/Users/peaker/dev/kitchen-app/backoffice/src/views/counteragents/components/counteragents/CounteragentsTable.vue", "Vue", 0, 0, 342, 0, 0, 15, 50, 407
"/Users/peaker/dev/kitchen-app/backoffice/src/views/counteragents/components/dialogs/BalanceCorrectionDialog.vue", "Vue", 0, 0, 335, 0, 0, 8, 49, 392
"/Users/peaker/dev/kitchen-app/backoffice/src/views/counteragents/components/shared/ContactInfo.vue", "Vue", 0, 0, 165, 0, 0, 6, 26, 197
"/Users/peaker/dev/kitchen-app/backoffice/src/views/debug/DebugView.vue", "Vue", 0, 0, 488, 0, 0, 27, 62, 577
"/Users/peaker/dev/kitchen-app/backoffice/src/views/debug/components/JsonNavigator.vue", "Vue", 0, 0, 506, 0, 0, 9, 82, 597
"/Users/peaker/dev/kitchen-app/backoffice/src/views/debug/components/JsonTreeNode.vue", "Vue", 0, 0, 425, 0, 0, 14, 89, 528
"/Users/peaker/dev/kitchen-app/backoffice/src/views/menu/MenuView.vue", "Vue", 0, 0, 347, 0, 0, 7, 48, 402
"/Users/peaker/dev/kitchen-app/backoffice/src/views/menu/components/MenuCategoryDialog.vue", "Vue", 0, 0, 163, 0, 0, 0, 24, 187
"/Users/peaker/dev/kitchen-app/backoffice/src/views/menu/components/MenuItem.vue", "Vue", 0, 0, 261, 0, 0, 5, 37, 303
"/Users/peaker/dev/kitchen-app/backoffice/src/views/menu/components/MenuItemDialog.vue", "Vue", 0, 0, 399, 0, 0, 6, 47, 452
"/Users/peaker/dev/kitchen-app/backoffice/src/views/menu/components/MenuItemVariant.vue", "Vue", 0, 0, 493, 0, 0, 13, 58, 564
"/Users/peaker/dev/kitchen-app/backoffice/src/views/pos/PosMainView.vue", "Vue", 0, 0, 438, 0, 0, 8, 71, 517
"/Users/peaker/dev/kitchen-app/backoffice/src/views/pos/components/ConfirmDialog.vue", "Vue", 0, 0, 111, 0, 0, 4, 18, 133
"/Users/peaker/dev/kitchen-app/backoffice/src/views/pos/components/PaymentDialog.vue", "Vue", 0, 0, 289, 0, 0, 10, 50, 349
"/Users/peaker/dev/kitchen-app/backoffice/src/views/pos/components/PaymentSection.vue", "Vue", 0, 0, 289, 0, 0, 10, 50, 349
"/Users/peaker/dev/kitchen-app/backoffice/src/views/pos/components/PosNavigationMenu.vue", "Vue", 0, 0, 335, 0, 0, 7, 61, 403
"/Users/peaker/dev/kitchen-app/backoffice/src/views/pos/menu/MenuSection.vue", "Vue", 0, 0, 331, 0, 0, 9, 48, 388
"/Users/peaker/dev/kitchen-app/backoffice/src/views/pos/menu/components/CategoryCard.vue", "Vue", 0, 0, 174, 0, 0, 4, 37, 215
"/Users/peaker/dev/kitchen-app/backoffice/src/views/pos/menu/components/MenuItemCard.vue", "Vue", 0, 0, 314, 0, 0, 8, 61, 383
"/Users/peaker/dev/kitchen-app/backoffice/src/views/pos/order/OrderSection.vue", "Vue", 0, 0, 651, 0, 0, 13, 115, 779
"/Users/peaker/dev/kitchen-app/backoffice/src/views/pos/order/components/BillItem.vue", "Vue", 0, 0, 550, 0, 0, 12, 101, 663
"/Users/peaker/dev/kitchen-app/backoffice/src/views/pos/order/components/BillsManager.vue", "Vue", 0, 0, 268, 0, 0, 6, 49, 323
"/Users/peaker/dev/kitchen-app/backoffice/src/views/pos/order/components/BillsTabs.vue", "Vue", 0, 0, 468, 0, 0, 13, 78, 559
"/Users/peaker/dev/kitchen-app/backoffice/src/views/pos/order/components/OrderActions.vue", "Vue", 0, 0, 227, 0, 0, 8, 38, 273
"/Users/peaker/dev/kitchen-app/backoffice/src/views/pos/order/components/OrderInfo.vue", "Vue", 0, 0, 296, 0, 0, 6, 67, 369
"/Users/peaker/dev/kitchen-app/backoffice/src/views/pos/order/components/OrderTotals.vue", "Vue", 0, 0, 200, 0, 0, 10, 43, 253
"/Users/peaker/dev/kitchen-app/backoffice/src/views/pos/order/dialogs/BillDiscountDialog.vue", "Vue", 0, 0, 66, 0, 0, 1, 10, 77
"/Users/peaker/dev/kitchen-app/backoffice/src/views/pos/order/dialogs/BillItemCancelDialog.vue", "Vue", 0, 0, 47, 0, 0, 1, 7, 55
"/Users/peaker/dev/kitchen-app/backoffice/src/views/pos/order/dialogs/BillItemEditDialog.vue", "Vue", 0, 0, 50, 0, 0, 1, 8, 59
"/Users/peaker/dev/kitchen-app/backoffice/src/views/pos/order/dialogs/BulkActionsDialog.vue", "Vue", 0, 0, 141, 0, 0, 6, 17, 164
"/Users/peaker/dev/kitchen-app/backoffice/src/views/pos/order/dialogs/CheckoutDialog.vue", "Vue", 0, 0, 131, 0, 0, 4, 16, 151
"/Users/peaker/dev/kitchen-app/backoffice/src/views/pos/order/dialogs/MoveItemsDialog.vue", "Vue", 0, 0, 64, 0, 0, 1, 11, 76
"/Users/peaker/dev/kitchen-app/backoffice/src/views/pos/order/dialogs/OrderTypeDialog.vue", "Vue", 0, 0, 77, 0, 0, 1, 12, 90
"/Users/peaker/dev/kitchen-app/backoffice/src/views/pos/shifts/dialogs/EndShiftDialog.vue", "Vue", 0, 0, 445, 0, 0, 13, 74, 532
"/Users/peaker/dev/kitchen-app/backoffice/src/views/pos/shifts/dialogs/StartShiftDialog.vue", "Vue", 0, 0, 258, 0, 0, 10, 48, 316
"/Users/peaker/dev/kitchen-app/backoffice/src/views/pos/tables/OrderItem.vue", "Vue", 0, 0, 417, 0, 0, 7, 72, 496
"/Users/peaker/dev/kitchen-app/backoffice/src/views/pos/tables/TableItem.vue", "Vue", 0, 0, 214, 0, 0, 3, 40, 257
"/Users/peaker/dev/kitchen-app/backoffice/src/views/pos/tables/TablesSidebar.vue", "Vue", 0, 0, 482, 0, 0, 8, 86, 576
"/Users/peaker/dev/kitchen-app/backoffice/src/views/pos/tables/components/SidebarItem.vue", "Vue", 0, 0, 396, 0, 0, 5, 76, 477
"/Users/peaker/dev/kitchen-app/backoffice/src/views/pos/tables/dialogs/OrderTypeDialog.vue", "Vue", 0, 0, 204, 0, 0, 5, 41, 250
"/Users/peaker/dev/kitchen-app/backoffice/src/views/products/ProductsView.vue", "Vue", 0, 0, 362, 0, 0, 9, 50, 421
"/Users/peaker/dev/kitchen-app/backoffice/src/views/products/components/PriceHistoryWidget.vue", "Vue", 0, 0, 589, 0, 0, 13, 100, 702
"/Users/peaker/dev/kitchen-app/backoffice/src/views/products/components/ProductCard.vue", "Vue", 0, 0, 405, 0, 0, 13, 50, 468
"/Users/peaker/dev/kitchen-app/backoffice/src/views/products/components/ProductDetailsDialog.vue", "Vue", 0, 0, 610, 0, 0, 20, 79, 709
"/Users/peaker/dev/kitchen-app/backoffice/src/views/products/components/ProductDialog.vue", "Vue", 0, 0, 607, 0, 0, 20, 65, 692
"/Users/peaker/dev/kitchen-app/backoffice/src/views/products/components/ProductsFilters.vue", "Vue", 0, 0, 269, 0, 0, 8, 35, 312
"/Users/peaker/dev/kitchen-app/backoffice/src/views/products/components/ProductsList.vue", "Vue", 0, 0, 257, 0, 0, 11, 31, 299
"/Users/peaker/dev/kitchen-app/backoffice/src/views/products/components/UsageTrackingWidget.vue", "Vue", 0, 0, 650, 0, 0, 10, 94, 754
"/Users/peaker/dev/kitchen-app/backoffice/src/views/products/components/package/PackageOptionDialog.vue", "Vue", 0, 0, 292, 0, 0, 1, 33, 326
"/Users/peaker/dev/kitchen-app/backoffice/src/views/products/components/package/PackageOptionsList.vue", "Vue", 0, 0, 112, 0, 0, 0, 14, 126
"/Users/peaker/dev/kitchen-app/backoffice/src/views/recipes/RecipesView.vue", "Vue", 0, 0, 649, 0, 0, 17, 90, 756
"/Users/peaker/dev/kitchen-app/backoffice/src/views/recipes/components/RecipeFilters.vue", "Vue", 0, 0, 322, 0, 0, 7, 55, 384
"/Users/peaker/dev/kitchen-app/backoffice/src/views/recipes/components/UnifiedRecipeDialog.vue", "Vue", 0, 0, 293, 0, 0, 4, 38, 335
"/Users/peaker/dev/kitchen-app/backoffice/src/views/recipes/components/UnifiedRecipeItem.vue", "Vue", 0, 0, 521, 0, 0, 14, 78, 613
"/Users/peaker/dev/kitchen-app/backoffice/src/views/recipes/components/UnifiedViewDialog.vue", "Vue", 0, 0, 350, 0, 0, 8, 57, 415
"/Users/peaker/dev/kitchen-app/backoffice/src/views/recipes/components/widgets/ComponentsListWidget.vue", "Vue", 0, 0, 234, 0, 0, 3, 32, 269
"/Users/peaker/dev/kitchen-app/backoffice/src/views/recipes/components/widgets/CostBreakdownWidget.vue", "Vue", 0, 0, 298, 0, 0, 4, 34, 336
"/Users/peaker/dev/kitchen-app/backoffice/src/views/recipes/components/widgets/CostInfoWidget.vue", "Vue", 0, 0, 159, 0, 0, 2, 26, 187
"/Users/peaker/dev/kitchen-app/backoffice/src/views/recipes/components/widgets/InstructionsWidget.vue", "Vue", 0, 0, 177, 0, 0, 4, 26, 207
"/Users/peaker/dev/kitchen-app/backoffice/src/views/recipes/components/widgets/ItemInfoWidget.vue", "Vue", 0, 0, 151, 0, 0, 6, 26, 183
"/Users/peaker/dev/kitchen-app/backoffice/src/views/recipes/components/widgets/RecipeBasicInfoWidget.vue", "Vue", 0, 0, 255, 0, 0, 9, 27, 291
"/Users/peaker/dev/kitchen-app/backoffice/src/views/recipes/components/widgets/RecipeComponentsEditorWidget.vue", "Vue", 0, 0, 559, 0, 0, 8, 75, 642
"/Users/peaker/dev/kitchen-app/backoffice/src/views/recipes/components/widgets/RecipeCostPreviewWidget.vue", "Vue", 0, 0, 199, 0, 0, 4, 32, 235
"/Users/peaker/dev/kitchen-app/backoffice/src/views/storage/StorageView.vue", "Vue", 0, 0, 619, 0, 0, 15, 87, 721
"/Users/peaker/dev/kitchen-app/backoffice/src/views/storage/components/AddReceiptItemDialog.vue", "Vue", 0, 0, 47, 0, 0, 2, 8, 57
"/Users/peaker/dev/kitchen-app/backoffice/src/views/storage/components/InventoryDetailsDialog.vue", "Vue", 0, 0, 385, 0, 0, 14, 48, 447
"/Users/peaker/dev/kitchen-app/backoffice/src/views/storage/components/InventoryDialog.vue", "Vue", 0, 0, 891, 0, 0, 13, 122, 1026
"/Users/peaker/dev/kitchen-app/backoffice/src/views/storage/components/InventoryItemRow.vue", "Vue", 0, 0, 261, 0, 0, 11, 38, 310
"/Users/peaker/dev/kitchen-app/backoffice/src/views/storage/components/ItemDetailsDialog.vue", "Vue", 0, 0, 341, 0, 0, 9, 54, 404
"/Users/peaker/dev/kitchen-app/backoffice/src/views/storage/components/ReceiptDialog.vue", "Vue", 0, 0, 302, 0, 0, 9, 49, 360
"/Users/peaker/dev/kitchen-app/backoffice/src/views/storage/components/ReceiptItemCard.vue", "Vue", 0, 0, 183, 0, 0, 6, 24, 213
"/Users/peaker/dev/kitchen-app/backoffice/src/views/storage/components/StorageAlerts.vue", "Vue", 0, 0, 139, 0, 0, 5, 21, 165
"/Users/peaker/dev/kitchen-app/backoffice/src/views/storage/components/StorageInventoriesTable.vue", "Vue", 0, 0, 480, 0, 0, 20, 65, 565
"/Users/peaker/dev/kitchen-app/backoffice/src/views/storage/components/StorageOperationsTable.vue", "Vue", 0, 0, 467, 0, 0, 21, 54, 542
"/Users/peaker/dev/kitchen-app/backoffice/src/views/storage/components/StorageStockTable.vue", "Vue", 0, 0, 753, 0, 0, 27, 114, 894
"/Users/peaker/dev/kitchen-app/backoffice/src/views/storage/components/index.ts", "TypeScript", 11, 0, 0, 0, 0, 135, 21, 167
"/Users/peaker/dev/kitchen-app/backoffice/src/views/storage/components/tabs/StorageAnalyticsTab.vue", "Vue", 0, 0, 432, 0, 0, 13, 52, 497
"/Users/peaker/dev/kitchen-app/backoffice/src/views/storage/components/widgets/WriteOffStatsWidget.vue", "Vue", 0, 0, 424, 0, 0, 22, 43, 489
"/Users/peaker/dev/kitchen-app/backoffice/src/views/storage/components/writeoff/ProductCard.vue", "Vue", 0, 0, 265, 0, 0, 9, 50, 324
"/Users/peaker/dev/kitchen-app/backoffice/src/views/storage/components/writeoff/ProductListRow.vue", "Vue", 0, 0, 215, 0, 0, 8, 44, 267
"/Users/peaker/dev/kitchen-app/backoffice/src/views/storage/components/writeoff/ProductSelectorWidget.vue", "Vue", 0, 0, 778, 0, 0, 12, 116, 906
"/Users/peaker/dev/kitchen-app/backoffice/src/views/storage/components/writeoff/WriteOffDialog.vue", "Vue", 0, 0, 513, 0, 0, 21, 69, 603
"/Users/peaker/dev/kitchen-app/backoffice/src/views/storage/components/writeoff/WriteOffQuantityDialog.vue", "Vue", 0, 0, 503, 0, 0, 8, 77, 588
"/Users/peaker/dev/kitchen-app/backoffice/src/views/storage/components/writeoff/WriteOffWidget.vue", "Vue", 0, 0, 81, 0, 0, 5, 16, 102
"/Users/peaker/dev/kitchen-app/backoffice/src/views/supplier_2/SupplierView.vue", "Vue", 0, 0, 615, 0, 0, 20, 112, 747
"/Users/peaker/dev/kitchen-app/backoffice/src/views/supplier_2/components/orders/BaseSupplierBaskets.vue", "Vue", 0, 0, 564, 0, 0, 11, 105, 680
"/Users/peaker/dev/kitchen-app/backoffice/src/views/supplier_2/components/orders/BillCard.vue", "Vue", 0, 0, 243, 0, 0, 7, 36, 286
"/Users/peaker/dev/kitchen-app/backoffice/src/views/supplier_2/components/orders/PurchaseOrderDetailsDialog.vue", "Vue", 0, 0, 383, 0, 0, 9, 62, 454
"/Users/peaker/dev/kitchen-app/backoffice/src/views/supplier_2/components/orders/PurchaseOrderEditDialog.vue", "Vue", 0, 0, 419, 0, 0, 10, 79, 508
"/Users/peaker/dev/kitchen-app/backoffice/src/views/supplier_2/components/orders/PurchaseOrderTable.vue", "Vue", 0, 0, 501, 0, 0, 14, 76, 591
"/Users/peaker/dev/kitchen-app/backoffice/src/views/supplier_2/components/orders/ShortfallAlert.vue", "Vue", 0, 0, 96, 0, 0, 2, 17, 115
"/Users/peaker/dev/kitchen-app/backoffice/src/views/supplier_2/components/orders/basket/SupplierBasketsWidget.vue", "Vue", 0, 0, 175, 0, 0, 8, 27, 210
"/Users/peaker/dev/kitchen-app/backoffice/src/views/supplier_2/components/orders/basket/UnassignedItemsWidget.vue", "Vue", 0, 0, 233, 0, 0, 7, 33, 273
"/Users/peaker/dev/kitchen-app/backoffice/src/views/supplier_2/components/orders/order-edit/EditableOrderItemsWidget.vue", "Vue", 0, 0, 487, 0, 0, 17, 73, 577
"/Users/peaker/dev/kitchen-app/backoffice/src/views/supplier_2/components/orders/order/AttachBillDialog.vue", "Vue", 0, 0, 324, 0, 0, 11, 55, 390
"/Users/peaker/dev/kitchen-app/backoffice/src/views/supplier_2/components/orders/order/OrderItemsWidget.vue", "Vue", 0, 0, 241, 0, 0, 12, 30, 283
"/Users/peaker/dev/kitchen-app/backoffice/src/views/supplier_2/components/orders/order/OrderReceiptWidget.vue", "Vue", 0, 0, 196, 0, 0, 4, 29, 229
"/Users/peaker/dev/kitchen-app/backoffice/src/views/supplier_2/components/orders/order/PurchaseOrderPayment.vue", "Vue", 0, 0, 399, 0, 0, 14, 62, 475
"/Users/peaker/dev/kitchen-app/backoffice/src/views/supplier_2/components/procurement/AddItemDialog.vue", "Vue", 0, 0, 517, 0, 0, 8, 77, 602
"/Users/peaker/dev/kitchen-app/backoffice/src/views/supplier_2/components/procurement/ProcurementRequestTable.vue", "Vue", 0, 0, 392, 0, 0, 19, 67, 478
"/Users/peaker/dev/kitchen-app/backoffice/src/views/supplier_2/components/procurement/RequestDetailsDialog.vue", "Vue", 0, 0, 516, 0, 0, 16, 87, 619
"/Users/peaker/dev/kitchen-app/backoffice/src/views/supplier_2/components/procurement/RequestEditDialog.vue", "Vue", 0, 0, 434, 0, 0, 19, 71, 524
"/Users/peaker/dev/kitchen-app/backoffice/src/views/supplier_2/components/receipts/BaseReceiptDialog.vue", "Vue", 0, 0, 610, 0, 0, 11, 112, 733
"/Users/peaker/dev/kitchen-app/backoffice/src/views/supplier_2/components/receipts/ReceiptDetailsDialog.vue", "Vue", 0, 0, 427, 0, 0, 14, 79, 520
"/Users/peaker/dev/kitchen-app/backoffice/src/views/supplier_2/components/receipts/ReceiptDiscrepanciesDialog.vue", "Vue", 0, 0, 386, 0, 0, 13, 70, 469
"/Users/peaker/dev/kitchen-app/backoffice/src/views/supplier_2/components/receipts/ReceiptTable.vue", "Vue", 0, 0, 439, 0, 0, 18, 68, 525
"/Users/peaker/dev/kitchen-app/backoffice/src/views/supplier_2/components/receipts/receipt-edit/EditableReceiptItemsWidget.vue", "Vue", 0, 0, 660, 0, 0, 17, 124, 801
"/Users/peaker/dev/kitchen-app/backoffice/src/views/supplier_2/components/shared/BaseOrderAssistant.vue", "Vue", 0, 0, 373, 0, 0, 15, 56, 444
"/Users/peaker/dev/kitchen-app/backoffice/src/views/supplier_2/components/shared/ManualItemForm.vue", "Vue", 0, 0, 347, 0, 0, 6, 55, 408
"/Users/peaker/dev/kitchen-app/backoffice/src/views/supplier_2/components/shared/RequestSummaryPanel.vue", "Vue", 0, 0, 428, 0, 0, 8, 64, 500
"/Users/peaker/dev/kitchen-app/backoffice/src/views/supplier_2/components/shared/SuggestionItemCard.vue", "Vue", 0, 0, 389, 0, 0, 14, 79, 482
"/Users/peaker/dev/kitchen-app/backoffice/src/views/supplier_2/components/shared/package/PackageSelector.vue", "Vue", 0, 0, 518, 0, 0, 19, 75, 612
"/Users/peaker/dev/kitchen-app/backoffice/src/views/supplier_2/components/shared/package/QuickAddPackageDialog.vue", "Vue", 0, 0, 291, 0, 0, 7, 47, 345
"/Users/peaker/dev/kitchen-app/backoffice/src/vite-env.d.ts", "TypeScript", 0, 0, 0, 0, 0, 1, 1, 2
"Total", "-", 42452, 1, 55980, 554, 6310, 9497, 18682, 133476