"filename", "language", "Vue", "TypeScript", "comment", "blank", "total"
"/Users/peaker/dev/kitchen-app/backoffice/src/stores/debug/debugService.ts", "TypeScript", 0, 82, 14, 13, 109
"/Users/peaker/dev/kitchen-app/backoffice/src/stores/preparation/composables/usePreparationWriteOff.ts", "TypeScript", 0, 383, 82, 63, 528
"/Users/peaker/dev/kitchen-app/backoffice/src/stores/preparation/index.ts", "TypeScript", 0, 10, 2, 1, 13
"/Users/peaker/dev/kitchen-app/backoffice/src/stores/preparation/preparationService.ts", "TypeScript", 0, 255, -29, 32, 258
"/Users/peaker/dev/kitchen-app/backoffice/src/stores/preparation/preparationStore.ts", "TypeScript", 0, 81, -6, 2, 77
"/Users/peaker/dev/kitchen-app/backoffice/src/stores/preparation/types.ts", "TypeScript", 0, 148, -25, -17, 106
"/Users/peaker/dev/kitchen-app/backoffice/src/stores/storage/storageService.ts", "TypeScript", 0, 212, 27, 43, 282
"/Users/peaker/dev/kitchen-app/backoffice/src/stores/storage/storageStore.ts", "TypeScript", 0, 54, 4, 13, 71
"/Users/peaker/dev/kitchen-app/backoffice/src/views/Preparation/PreparationView.vue", "Vue", 72, 0, 2, 16, 90
"/Users/peaker/dev/kitchen-app/backoffice/src/views/Preparation/components/PreparationStockTable.vue", "Vue", 277, 0, 5, 33, 315
"/Users/peaker/dev/kitchen-app/backoffice/src/views/Preparation/components/writeoff/PreparationQuantityDialog.vue", "Vue", 479, 0, 8, 75, 562
"/Users/peaker/dev/kitchen-app/backoffice/src/views/Preparation/components/writeoff/PreparationSelectorWidget.vue", "Vue", 324, 0, 7, 55, 386
"/Users/peaker/dev/kitchen-app/backoffice/src/views/Preparation/components/writeoff/PreparationWriteOffDialog.vue", "Vue", 510, 0, 20, 64, 594
"/Users/peaker/dev/kitchen-app/backoffice/src/views/Preparation/components/writeoff/PreparationWriteOffWidget.vue", "Vue", 81, 0, 5, 16, 102
"/Users/peaker/dev/kitchen-app/backoffice/src/views/storage/StorageView.vue", "Vue", 120, 0, -2, 28, 146
"/Users/peaker/dev/kitchen-app/backoffice/src/views/storage/components/InventoryDialog.vue", "Vue", 111, 0, 2, 11, 124
"/Users/peaker/dev/kitchen-app/backoffice/src/views/storage/components/InventoryItemRow.vue", "Vue", 16, 0, 1, 0, 17
"/Users/peaker/dev/kitchen-app/backoffice/src/views/storage/components/StorageAlerts.vue", "Vue", 47, 0, 3, 7, 57
"/Users/peaker/dev/kitchen-app/backoffice/src/views/storage/components/StorageStockTable.vue", "Vue", 204, 0, 7, 27, 238
"Total", "-", 2241, 1225, 127, 482, 4075